Ifac - Instituto Federal do Acre
Ufac - Universidade Federal do Acre
FADISI - Faculdade Diocesana São José
ESAB – Escola Superior Aberta do Brasil
ESB – Instituto de Ensino Superior Brasileiro
FAAO - Faculdade da Amazônia Ocidental
FCE - Faculdade Campos Elíseos
FACEL – Faculdade de Administração, Ciências, Educação e Letras
Faculdade Futura
FAP - Faculdade Pitágoras
FAVENI - Faculdade Venda Nova do Imigrante
Iesacre - Instituição de Ensino Superior do Acre
IEESE - Instituto de Educação e Ensino Superior Ebenézer
UNAMA - Universidade da Amazônia
UNESA - Universidade Estácio de Sá
Uninorte - Centro Universitário Uninorte
UNINTER - Grupo Educacional Uninter
Uneal - Universidade Estadual de Alagoas
Uncisal - Universidade Estadual de Ciências da Saúde de Alagoas
Ifal - Instituto Federal de Alagoas
Ufal - Universidade Federal de Alagoas
CESMAC - Centro de Estudos Superiores de Maceió
FAA & IESA - Associação de Ensino Superior de Alagoas
FACIMA - Faculdade da Cidade de Maceió
FAP - Faculdade Pitágoras
FITS - Faculdade Integrada Tiradentes
Ueap - Universidade Estadual do Amapá
IFAP - Instituto Federal do Amapá
UNIFAP - Universidade Federal do Amapá
CEAP - Centro de Ensino Superior do Amapá
FABRAN - Faculdade Brasil Norte
FAMA - Faculdade do Amapá
FESAM - Faculdade de Ensino Superior da Amazônia
IESAP - Instituto de Ensino Superior do Amapá
IMMES - Instituto Macapaense do Melhor Ensino Superior
META - Faculdade Meta
UEA - Universidade do Estado do Amazonas
IFAM - Instituto Federal do Amazonas
UFAM - Universidade Federal do Amazonas
INPA-Instituto Nacional de Pesquisas da Amazônia
ULBRA - Universidade Luterana do Brasil
FSDB - Faculdade Salesiana Dom Bosco
Ciesa - Centro Universitário de Ensino Superior do Amazonas
UNINILTONLINS - Universidade Nilton Lins
Cesf - Instituto de Ensino Superior Fucapi
FT - Faculdade Táhirih
Fametro - Faculdade Metropolitana de Manaus
FMF - Faculdade Martha Falcão
Fal - Faculdade Literatus
Unisalle - Faculdade La Salle
Iaes - Faculdade do Amazonas
Fom - Faculdade de Odontologia de Manaus
FBNCTSB - Faculdade Boas Novas de Ciências Teológicas, Sociais e Biotecnológicas
Esbam - Escola Superior Batista do Amazonas
Uninorte - Centro Universitário do Norte
Unip - Universidade Paulista
UECE - Universidade Estadual do Ceará
URCA - Universidade Regional do Cariri
UVA - Universidade Estadual Vale do Acaraú
IFCE - Instituto Federal do Ceará
UFC - Universidade Federal do Ceará
UNILAB - Universidade Federal de Integração Luso-Afro-Brasileira
UFCA - Universidade Federal do Cariri
CENTEC - Falcudade de Tecnologia CENTEC
FCC - Faculdade Católica do Ceará
FCF - Faculdade Católica de Fortaleza
FCRS - Faculdade Católica Rainha do Sertão
INTA - Instituto Superior de Teologia Aplicada
IESF - Instituto de Ensino Superior de Fortaleza
UNICHRISTUS - Centro Universitário Christus
UNIFAMETRO - Centro Universitário Fametro
UNIFOR - Universidade de Fortaleza
UNIFANOR - Centro Universitário Unifanor
UNIGRANDE - Centro Universitário da Grande Fortaleza
UPA - Universidade Patativa do Assaré
UNICATÓLICA-Centro Universitário Católica de Quixadá
ESTÁCIO FIC - Faculdade Integrada do Ceará
FA7 - Faculdade 7 de Setembro
FAC - Faculdades Cearenses
FACE - Faculdade Evolutivo
FAECE - Faculdade de Ensino e Cultura do Ceará
FAFOR - Faculdade de Fortaleza
FALS - Faculdade de Ciências Aplicadas Doutor Leão Sampaio
FAP - Faculdade Paraíso do Ceará
FAS - Faculdade Ari de Sá
FATE - Faculdade Ateneu
FATENE - Faculdade Terra Nordeste
FFB - Faculdade Farias Brito
FJN - Faculdade de Juazeiro do Norte
FLF - Faculdade Luciano Feijão
FMJ - Faculdade de Medicina de Juazeiro do Norte
FTA - Faculdade de Tecnologia Apoena
FVJ - Faculdade Vale do Jaguaribe
UNIASSELVI - Centro Universitário Leonardo da Vinci
ESCS - Escola Superior de Ciências da Saúde
IFB - Instituto Federal de Brasília
UnB - Universidade de Brasília
ENAP-Escola Nacional de Administração Pública
UCB - Universidade Católica de Brasília
UPIS - União Pioneira de Integração Social
SENAI - Serviço Nacional de Aprendizagem Industrial
CEUB - Centro Universitário de Brasília
FATE - Faculdade Ateneu
FACIPLAC - Faculdade de Ciência e Tecnologia do Planalto Central
FACITEC - Faculdade de Ciências Sociais e Tecnológicas
FACICESP - FACULDADES INTEGRADAS ICESP - UNICESP - Brasília
FASEP - Faculdade Serrana
IESB - Instituto de Educação Superior de Brasília
SENAC - Faculdade Senac - Distrito Federal
UDF - Centro Universitário do Distrito Federal
UNIEURO - Centro Universitário Euroamericano
UNIDESC - Centro Universitário de Desenvolvimento do Centro Oeste
UNIP - Universidade Paulista
UNIPLAN - Centro Universitário Planalto do Distrito Federal
UNISEB - Centro Universitário Estácio UniSEB - Brasília
UNOPAR - Universidade Norte do Paraná
FACELI - Faculdade de Ensino Superior de Linhares
FAMES - Faculdade De Musica do Espírito Santo" Mauricio de Oliveira"
IFES - Instituto Federal do Espírito Santo
UFES - Universidade Federal do Espírito Santo
EMESCAM - Escola Superior de Ciências da Santa Casa de Misericórdia de Vitória
FAPECS - Instituto de Pesquisa em Ciências da Saude
UVV - Universidade Vila Velha
UNESC - Centro Universitário do Espírito Santo
FAESA - Faculdades Integradas Espírito-Santenses
UCL - Faculdade do Centro Leste
Favi/FACES - Faculdade do Espírito Santo
ESFA - Escola Superior São Francisco de Assis
CUSC - Centro Universitário São Camilo
FAFIA - Faculdade de Filosofia Ciências e Letras de Alegre
FCB - Faculdade Castelo Branco
CESAT - Escola de Ensino Superior Anísio Teixeira
CESV - Centro de Ensino Superior de Vitória
DOCTUM - Rede de Ensino Doctum
FABAVI - Faculdade Batista de Vitoria
FAACZ - Faculdade de Aracruz
FACE - Faculdade Casa do Estudante
FACES - Faculdade do Espírito Santo
FASE - Faculdade da Serra
FAVI - Associação Vitoriana de Ensino Superior
FCMV - Faculdade Candido Mendes de Vitória
FDV - Faculdades Integradas de Vitória
FUCAPE - FUCAPE Business School
MULTIVIX - Faculdade Brasileira
PIO XII - Faculdade de Estudos Sociais do Espírito Santo
SABERES - Faculdade Saberes
UNESA - Universidade Estácio de Sá
UniRV (FESURV) - Universidade de Rio Verde
UEG - Universidade Estadual de Goiás
IFG - Instituto Federal de Goiás
UFG - Universidade Federal de Goiás
IF Goiano - Instituto Federal Goiano
UFCat - Universidade Federal de Catalão
UFJat - Universidade Federal de Jataí
IPOG - Instituto de Pós-Graduação
PUC - Pontifícia Universidade Católica de Goiás
UNIVERSO - Universidade Salgado de Oliveira
Fac - Faculdade Católica de Anápolis
ULBRA - Universidade Luterana do Brasil
Fasug - Faculdade do Sudeste Goiano
ALFA - Faculdade Alves Faria
CESUC - Centro de Ensino Superior de Catalão
FACERES - Faculdade de Ceres
FACER - Faculdade de Ciências de Rubiataba
FACEG - Faculdade Evangelica de Goianesia
Facmais - Faculdade de Inhumas
FAA - Faculdade Anhanguera de Anápolis
FASAM - Faculdade Sul-Americana
IESRIVER - Instituto de Ensino Superior de Rio Verde
INSJAR - Instituto Jordão de Arruda
UNESA - Universidade Estácio de Sá
UNIP - Universidade Paulista
UNIFASC - Faculdade Santa Rita de Cássia
UniEvangelica - Universidade Evangélica
Unianhanguera - Universidade Anhanguera
IAESUP - Faculdades e Colégio Aphonsiano
IUESO - Instituto Unificado de Ensino Superior Objetivo
FMB - Faculdade Montes Belos
UEMA - Universidade Estadual do Maranhão
UEMASUL - Universidade Estadual da Região Tocantina do Maranhão
IEMA - Instituto Estadual do Maranhão
IFMA - Instituto Federal do Maranhão
UFMA - Universidade Federal do Maranhão
CEST - Faculdade Santa Terezinha (São Luís)
FACEM - Faculdade do Estado do Maranhão (São Luís)
UNIFACEMA - Faculdade de Ciências e Tecnologia do Maranhão (Caxias)
FACIMP - Faculdade de Imperatriz
FAMA - Faculdade Atenas Maranhense
FAP - Faculdade do Baixo Paranaíba (Chapadinha)
FEST - Faculdade de Educação Santa Terezinha (Imperatriz)
FSL - Faculdade São Luís
IESF - Instituto de Ensino Superior Franciscano (Paço do Lumiar)
IMEC - Instituto Maranhense de Ensino e Cultura (São Luís)
UNDB - Centro Universitário Dom Bosco (São Luís)
CEUMA - Universidade CEUMA (São Luís)
UNEMAT - Universidade do Estado de Mato Grosso
IFMT - Instituto Federal do Mato Grosso
UFMT - Universidade Federal de Mato Grosso
IUMSL - Instituto Universitário Museo Social Libertas
FAUC - Faculdade Cuiabá
FCR - Faculdade Cândido Rondon
FAUSB - Faculdade Desembargador Sávio Brandão
CATHEDRAL - Faculdades Cathedral-Barra do Garças
EDUVALE - Faculdade de Ciências Sociais Aplicadas do Vale do São Lourenço
FADAF - Faculdade de Direito de Alta Floresta
FAPAN - Faculdade do Pantanal
FASIPE - Faculdade FASIPE
ICEC - Instituto Cuiabá de Ensino e Cultura
IESMT - Instituto de Ensino Superior de Mato Grosso
LA SALLE - Faculdade La Salle
ULBRA - Universidade Luterana do Brasil - EAD
UNIC - Universidade de Cuiabá
UNIP - Universidade Paulista
UNIRONDON - Centro Universitário Cândido Rondon
UNIVAG - Centro Universitário de Várzea Grande
UNIVAR - Universidades Unidas do Vale do Araguaia-Barra do Garças
UEMS - Universidade Estadual do Mato Grosso do Sul
UFGD - Universidade Federal da Grande Dourados
IFMS - Instituto Federal de Mato Grosso do Sul
UFMS - Universidade Federal do Mato Grosso do Sul
UCDB - Universidade Católica Dom Bosco
AEMS - Faculdades Integradas de Três Lagoas
FCG - Faculdade Campo Grande
FACSUL - Faculdade Mato Grosso do Sul
UNAES - Centro Universitário de Campo Grande
UNIDERP - Universidade para o Desenvolvimento do Estado e Região do Pantanal
UNIGRAN - Centro Universitário da Grande Dourados
FJP - Fundação João Pinheiro
UEMG - Universidade do Estado de Minas Gerais
UNIMONTES - Universidade Estadual de Montes Claros
CEFET-MG - Centro Federal de Educação Tecnológica de Minas Gerais
IFMG - Instituto Federal de Minas Gerais
IFNMG - Instituto Federal do Norte de Minas Gerais
IFSM - Instituto Federal do Sudeste de Minas
IFSULDEMINAS - Instituto Federal do Sul de Minas
IFTM - Instituto Federal do Triângulo Mineiro
UFJF - Universidade Federal de Juiz de Fora
UFLA - Universidade Federal de Lavras
UFMG - Universidade Federal de Minas Gerais
UFOP - Universidade Federal de Ouro Preto
UFSJ - Universidade Federal de São João del-Rei
UFTM - Universidade Federal do Triângulo Mineiro
UFU - Universidade Federal de Uberlândia
UFV - Universidade Federal de Viçosa
UFVJM - Universidade Federal dos Vales do Jequitinhonha e Mucuri
UNIFAL - Universidade Federal de Alfenas
UNIFEI - Universidade Federal de Itajubá
APM-MG - Academia de Polícia Militar de Minas Gerais
EEK - Escola de Engenharia Kennedy
EEWB - Escola de Enfermagem Wenceslau Braz
ESDHC - Escola Superior Dom Helder Câmara
FACAPA - Faculdade Católica de Pouso Alegre
FACSFX - Faculdade São Francisco Xavier
FADIPA - Faculdade de Direito de Ipatinga
FAC - Faculdade Arquidiocesana de Curvelo
FAP - Faculdade Arquidiocesana de Pirapora
FADMINAS - Faculdades Integradas Adventistas de Minas Gerais
FAGAMMON - Faculdade Presbiteriana Gammon
FDSM - Faculdade de Direito do Sul de Minas
FAC FUNAM - Faculdade de Tecnologia Alto e Médio São Francisco
FACECA - Faculdade Cenecista de Varginha
FASF/Unisa - Faculdade de Filosofia, Ciências e Letras do Alto São Francisco
FAZU - Faculdades Associadas de Uberaba
FCMMG - Faculdade de Ciências Médicas de Minas Gerais
FCMS/JF - Faculdade de Ciências Médicas e da Saúde de Juiz de Fora
FMG - Faculdade Metodista Granbery
FMIT - Faculdade de Medicina de Itajubá
FUNJOB - Faculdade de Medicina de Barbacena
FMS - Faculdade Machado Sobrinho
FUMEC - Fundação Mineira de Educação e Cultura
FUNCESI - Fundação Comunitária de Ensino Superior de Itabira
INATEL - Instituto Nacional de Telecomunicações
IESP - Instituto de Educação Superior de Patrocínio
PUCMG - Pontifícia Universidade Católica de Minas Gerais
UIT - Universidade de Itaúna
UNIARAXÁ - Centro Universitário do Planalto de Araxá
UNIBH - Centro Universitário de Belo Horizonte
UNICERP - Centro Universitário do Cerrado - Patrocínio
UNIFEMM - Centro Universitário de Sete Lagoas "Monsenhor Messias"
UNIFORMG - Centro Universitário de Formiga
UNILESTE - Centro Universitário do Leste de Minas Gerais
UNIPAC - Universidade Presidente Antônio Carlos
UNIPAM - Centro Universitário de Patos de Minas
UNITRI - Centro Universitário do Triângulo
UNIUBE - Universidade de Uberaba
UNIVAS - Universidade do Vale do Sapucaí
UNIVALE - Universidade Vale do Rio Doce
UNINCOR-Universidade Vale do Rio Verde
UNIVERSO - Universidade Salgado de Oliveira
CUEA - Centro Universitário Eaprenda Elearning
ASMEC - Associação Sul Mineira de Educação e Cultura
CECON - Centro Educacional Conceição Nunes
CENSI - Centro de Ensino Superior de Itabira
DOCTUM - Rede de Ensino Doctum
FACEMG - Faculdade de Ensino de Minas Gerais
FACESM - Faculdade de Ciências Sociais Aplicadas do Sul de Minas
FACICA - Faculdade de Ciências da Saúde de Campos Gerais
FACED - Faculdade de Ciências Contabeis de Divinópolis
FACIC - Faculdade de Ciências Humanas de Curvelo
FACSUM - Faculdade do Sudeste Mineiro
FACTU - Faculdade de Ciências e Tecnologia de Unaí
FAF - Faculdade de Frutal
FAJESSEN - Faculdade Arnaldo Jessen
FAVENORTE - Instituto Superior de Educação Verde Norte
FEMG - Faculdade de Engenharia de Minas Gerais
FJF - Faculdade Juiz de Fora
FMC - Faculdades Milton Campos
FPAS - Faculdade Pitágoras de Administração Superior
FPMG - Faculdade Promove de Minas Gerais
FPU - Faculdade Politécnica de Uberlândia
FSA - Faculdades Santo Agostinho
FUC - Faculdades Unificadas de Cataguases
FUNEDI - Fundação Educacional de Divinópolis
IBHES - Instituto Belo Horizonte de Ensino Superior
INESC - Instituto de Ensino Superior Cenecista
IPTAN - Instituto de Ensino Superior Presidente Tancredo Neves
ISEC - Instituto Superior de Educação de Campos Gerais
SECAL - Faculdade Santa Amélia
UNA - Centro Universitário UNA
NEWTON-Centro Universitário Newton Paiva
UNIFENAS - Universidade de Alfenas José do Rosário Vellano
UNILAVRAS - Centro Universitário de Lavras
UNIVERSITAS - Centro Universitário de Itajubá
UNIVIÇOSA - União de Ensino Superior de Viçosa
UFRA - Universidade Federal Rural da Amazônia
UFPA - Universidade Federal do Pará
IFPA - Instituto Federal do Pará
UFOPA - Universidade Federal do Oeste do Pará
UNIFESSPA - Universidade Federal do Sul e Sudeste do Pará
UEPA - Universidade do Estado do Pará
CIABA - Centro de Instrução Almirante Braz de Aguiar
CEAMA - Centro de Educação da Amazônia
CESUPA - Centro Universitário do Pará
ESMAC - Escola Superior Madre Celeste
ESAMAZ - Escola Superior da Amazônia
ESTÁCIO FAP - Estácio de Sá Faculdade do Pará
FAAMA - Faculdade Adventista da Amazônia
FAAM - Faculdade da Amazônia
FAMAZ - Faculdade Metropolitana da Amazônia
FABEL - Faculdade de Belém
FACETE - Faculdade de Ensino Tecnológico do Estado do Pará
FACI - Faculdade Ideal
FACIP - Faculdade Ipiranga
FAPAN - Faculdade Pan Amazônica
FAPEN - Faculdade Paraense de Ensino
FCAT - Faculdade de Castanhal
FEAPA - Faculdade de Estudos Avançados do Pará
FIT - Faculdades Integradas do Tapajós (Santarém)
FIBRA - Faculdade Integrada Brasil Amazônia
FMM - Faculdade Metropolitana de Marabá
FPA - Faculdade Pan Americana
IESAM - Instituto de Ensinos Superiores da Amazônia
UNAMA - Universidade da Amazônia
UNIP - Universidade Paulista
UNIPLAN
UEPB - Universidade Estadual da Paraíba
IFPB - Instituto Federal da Paraíba
UFPB - Universidade Federal da Paraíba
UFCG - Universidade Federal de Campina Grande
UNIPÊ - Centro Universitário de João Pessoa
ASPER - Associação Paraibana de Ensino Renovado
DEVRY - DeVry João Pessoa
ESAC - Escola Superior de Aviação Civil
ESBJ - Faculdade Maurício de Nassau
FAC - Faculdade de Campina Grande
FACENE - Faculdade de Enfermagem Nova Esperança
UNIBRASIL - Centro Universitário Autônomo do Brasil
FAFIC - Faculdade de Filosofía, Ciências e Letras de Cajazeiras
FAFIL - Faculdade de Filosofía Ciências e Letras
FAP - Faculdade Paraibana
FARR - Faculdade Reinaldo Ramos
FASER - Faculdade Santa Emília de Rodat
FASP - Faculdade São Francisco da Paraíba
FATEC - Faculdade de Tecnologia de João Pessoa
FATECPB - Faculdade de Tecnología da Paraíba
FAVAP - Faculdades Vale do Piancó
FCM - Faculdade de Ciências Médicas de Campina Grande
FCM-PB - Faculdade de Ciências Médicas da Paraíba
FEF - Faculdade Evilásio Formiga
FESVIP - Faculdade de Enfermagem São Vicente de Paula
FESP - Faculdade de Ensino Superior da Paraíba
FIAA - Faculdades Integradas Anglo-Americano
FPB - Faculdade Potiguar da Paraíba
FPB - Faculdade Internacional da Paraíba
FPPD - Faculdade Paraibana de Processamento de Dados
FSM - Faculdade Santa María
IESP - Instituto de Educação Superior da Paraíba
INPER - Insituto Paraibano de Ensino Renovado
IPOG - Instituto de Pós-Graduação & Graduação
ISEC - Instituto Superior de Educação de Cajazeiras
LUMEN FAC - Faculdade de Ciências Contábeis Luiz Mendes
UNIBRATEC - Faculdade de Tecnologia Ibratec
UNIFIP - Centro Universitário de Patos
UNIPB - Faculdade Unida da Paraíba
UNIUOL - Faculdade de Tecnologia do Uniuol
UNESPAR - Universidade Estadual do Paraná
UEL - Universidade Estadual de Londrina
UEM - Universidade Estadual de Maringá
UENP - Universidade Estadual do Norte do Paraná
UEPG - Universidade Estadual de Ponta Grossa
UNICENTRO - Universidade Estadual do Centro-Oeste
UNIOESTE - Universidade Estadual do Oeste do Paraná
IFPR - Instituto Federal do Paraná
UTFPR - Universidade Tecnológica Federal do Paraná
UFPR - Universidade Federal do Paraná
UNILA - Universidade Federal da Integração Latino-Americana
UFFS - Universidade Federal da Fronteira do Sul
FAE - FAE Centro Universitário
FAG - Fundação Assis Gurgacz
FEPAR - Faculdade Evangélica do Paraná
FPP - Faculdades Pequeno Príncipe
FTSA - Faculdade Teológica Sul Americana
PUCPR - Pontifícia Universidade Católica do Paraná
UNIFIL - Centro Universitário Filadélfia
Univel - União Educacional de Cascavel
UNINGÁ - Faculdade Ingá
CAMPO REAL - Faculdade Campo Real
CESCAGE - Centro de Ensino Superior dos Campos Gerais
CESUFOZ - Centro de Ensino Superior de Foz do Iguaçu
FAAB - Faculdade Alfa Brasil
FAC - Faculdade Curitibana
FAFIG - Faculdade de Foz do Iguaçu
FAG - Faculdade Guairacá
FAJAR - Faculdade Jaguariaíva
FATEB - Faculdade de Telêmaco Borba
FANP - Faculdade do Noroeste Paranaense
FAPAR - Faculdade Paranaense
FAPI - Faculdades de Pinhais
FASF - Faculdade Sagrada Família
FARESC - Faculdades Integradas Santa Cruz de Curitiba
FEITEP - Faculdade de Engenharia e Inovação Técnico Profissional
FESC - Fundação de Ensino Superior de Clevelândia
FG - Faculdade Guarapuava
FIES - Faculdades Integradas Espírita
FML - Faculdade Metropolitana Londrinense
OPET - Organização Paranaense de Ensino Técnico
SECAL - Faculdade Santa Amélia
UDC - Centro Universitário União Dinâmica das Cataratas
UEB - Universidade Eletrônica do Brasil
UNIANDRADE - Centro Universitário Campos de Andrade
UNICAMPO - Faculdade União de Campo Mourão[19]
INTEGRADO - Centro Universitário Integrado de Campo Mourão
UniCesumar - Centro Universitário de Maringá
UNICURITIBA - Centro Universitário Curitiba
UNINTER - Grupo Educacional Uninter
UNIPAR - Universidade Paranaense
UNOPAR - Universidade do Norte do Paraná
UCP - Faculdades do Centro do Paraná
UP - Universidade Positivo
UTP - Universidade Tuiuti do Paraná
UNISEP - União de Ensino do Sudoeste do Paraná
UFPI - Universidade Federal do Piauí
IFPI - Instituto Federal do Piauí
UFPDra - Universidade Federal do Delta do Parnaíba
UESPI - Universidade Estadual do Piauí
ISEAF - Instituto de Educação Antonino Freire
ICESPI - Instituto Católico de Estudos de Ensino Superior do Piauí
UNINOVAFAPI - Centro Universitário Uninovafapi
UNIFSA - Centro Universitário Santo Agostinho
UNIFAPI - Centro Universitário do Piauí
UNINASSAU - Centro Universitário Maurício de Nassau
UNIFACID - Faculdade Integral Diferencial
CESVALE - Centro de Ensino Superior Vale do Parnaíba
CEUT - Centro de Ensino Unificado de Teresina
ICF - Instituto Camilo Filho
CET - Centro de Educação Tecnológico
IERSA - Instituto Educacional Raimundo Sá
FAETE - Faculdade das atividades empresariais de Teresina
FAST - Faculdade Santa Teresa D'avilla
CHISFAPI - Christus Faculdade do Piauí
FCPI - Faculdade do Cerrado Piauiense
FeMASS - Faculdade Professor Miguel Ângelo da Silva Santos - Macaé
ISERJ - Instituto Superior de Educação do Rio de Janeiro
FAETERJ - Faculdade de Educação Tecnológica do Estado do Rio de Janeiro
UENF - Universidade Estadual do Norte Fluminense
UERJ - Universidade do Estado do Rio de Janeiro
UEZO - Universidade Estadual da Zona Oeste
IMPA-Instituto de Matemática Pura e Aplicada
CBPF - Centro Brasileiro de Pesquisas Físicas
CEFET/RJ - Centro Federal de Educação Tecnológica Celso Suckow da Fonseca
ENCE - Escola Nacional de Ciências Estatísticas
IFF - Instituto Federal Fluminense
IFRJ - Instituto Federal do Rio de Janeiro
UFF - Universidade Federal Fluminense
UFRJ - Universidade Federal do Rio de Janeiro
UFRRJ - Universidade Federal Rural do Rio de Janeiro
UNIRIO - Universidade Federal do Estado do Rio de Janeiro
ABMDP II - Academia de Bombeiro Militar Dom Pedro II
AMAN - Academia Militar de Agulhas Negras
APMDJVI - Academia de Polícia Militar Dom João VI
CIAGA - Centro de Instrução Almirante Graça Aranha
EN - Escola Naval
IME - Instituto Militar de Engenharia
MACKENZIE-RIO - Faculdade Presbiteriana Mackenzie Rio
IBMEC - Instituto Brasileiro de Mercado e Capitais
FGV - Fundação Getulio Vargas
ESPM-RIO - Escola Superior de Propaganda e Marketing
PUC-RIO - Pontifícia Universidade Católica do Rio de Janeiro
UNIGRANRIO - Universidade do Grande Rio
CELSO LISBOA - Centro Universitário Celso Lisboa
FUNENSEG - Escola Nacional de Seguros
FIJ - Faculdades Integradas de Jacarepaguá
FACHA - Faculdades Integradas Hélio Alonso
FFSD - Faculdade de Filosofia Santa Doroteia
FMC - Faculdade de Medicina de Campos
FSMA - Faculdade Salesiana de Macaé
FTESM - Fundação Técnico Educacional Souza Marques
FSB/RJ - Faculdade de São Bento do Rio de Janeiro
UCAM - Universidade Cândido Mendes
IBMR - Centro Universitário IBMR
UCB - Universidade Castelo Branco
UCP - Universidade Católica de Petrópolis
UGB - Centro Universitário Geraldo Di Biase
UGS - Universidade Gama e Souza
UNIFAA - Centro de Ensino Superior de Valença
UNISUAM - Centro Universitário Augusto Motta
UNIABEU - UNIABEU Centro Universitário
UNICARIOCA - Centro Universitário Carioca
UNIFESO - Centro Universitário Serra dos Órgãos
UNIVERSO - Universidade Salgado de Oliveira
USS - Universidade Severino Sombra
USU - Universidade Santa Úrsula
UVA - Universidade Veiga de Almeida
REDENTOR - Sociedade Universitária Redentor
UNIVERITAS - Centro Universitário Universus Veritas
FMP/FASE - Faculdade de Medicina de Petrópolis-Faculdade Arthur Sá Earp Neto
INFNET - Instituto Infnet
AEDB - Faculdades Dom Bosco
SENAC - Faculdade Senac Rio de Janeiro
UBM - Centro Universitário de Barra Mansa
UNESA - Universidade Estácio de Sá
UNIFOA - Centro Universitário de Volta Redonda
UERN - Universidade do Estado do Rio Grande do Norte
IFRN - Instituto Federal do Rio Grande do Norte
UFERSA - Universidade Federal Rural do Semi-Árido
UFRN - Universidade Federal do Rio Grande do Norte
ULBRA - Universidade Luterana do Brasil (Polo Natal)
UNP - Universidade Potiguar
FARN - Faculdade Natalense para o Desenvolvimento do Rio Grande do Norte
Fatern Gama Filho - Faculdade de Excelência do Rio Grande do Norte
FAL - Faculdade de Natal
Facex - Faculdade de Ciências, Cultura e Extensão do RN
FCC - Faculdade Câmara Cascudo
Fanec - Faculdade Natalense de Ensino e Cultura
FCNSN - Faculdade Católica Nossa Senhora Das Neves
UNOPAR - Universidade Norte do Paraná (Polo Natal)
UNINASSAU - Faculdade Maurício de Nassau - (Pólo Natal)
IPOG - Instituto de Pós-Graduação (Pólo Natal)
FCRN - Faculdade Católica do Rio Grande do Norte
Facene/RN - Faculdade de Enfermagem e Medicina Nova Esperança de Mossoró
Mater Christi - Faculdade Mater Christi
UERGS - Universidade Estadual do Rio Grande do Sul
FURG - Universidade Federal do Rio Grande
IFFarroupilha - Instituto Federal Farroupilha
IFRS - Instituto Federal do Rio Grande do Sul
IFSul - Instituto Federal Sul-rio-grandense
UFCSPA - Universidade Federal de Ciências da Saúde de Porto Alegre
UFPEL - Universidade Federal de Pelotas
UFRGS - Universidade Federal do Rio Grande do Sul
UFSM - Universidade Federal de Santa Maria
UNIPAMPA - Universidade Federal do Pampa
UFFS - Universidade Federal da Fronteira do Sul
CNECSAN - Faculdade CNEC Santo Ângelo
FACCAT - Faculdades de Taquara
FACOS - Faculdade Cenecista de Osório
FISMA - Faculdade Integrada de Santa Maria
FAPA - Faculdade Porto-Alegrense
FEEVALE - Universidade Feevale
FACENSA - Faculdade Cenecista Nossa Senhora dos Anjos
IACS - Instituto Adventista Cruzeiro do Sul
MARQUÊS - Instituto de Educação Cenecista Marquês de Herval
IPA - Centro Universitário Metodista do Instituto Porto Alegre
PUCRS - Pontifícia Universidade Católica do Rio Grande do Sul
UCPEL - Universidade Católica de Pelotas
UCS - Universidade de Caxias do Sul
ULBRA - Universidade Luterana do Brasil
UNICRUZ - Universidade de Cruz Alta
UFN - Universidade Franciscana
UNIJUÍ - Universidade Regional do Noroeste do Estado do Rio Grande do Sul
UNIRITTER - Centro Universitário Ritter dos Reis
UNILASALLE-RJ - Universidade La Salle - RJ
UNISC - Universidade de Santa Cruz do Sul
UNISINOS - Universidade do Vale do Rio dos Sinos
UNIVATES - Centro Universitário UNIVATES
UPF - Universidade de Passo Fundo
URCAMP - Universidade da Região da Campanha
URI - Universidade Regional Integrada do Alto Uruguai e das Missões
EST - Faculdades EST
CESF - Centro de Ensino Superior Cenecista de Farroupilha
CASTELLI - Escola Superior de Hotelaria Castelli
ESMARGS - Escola Superior de Música e Artes do Rio Grande do Sul
FADERGS - Faculdade de Desenvolvimento do Rio Grande do Sul
FAE - Faculdades Equipe - Sapucaia do Sul
FAM - Faculdade Antonio Meneghetti
FSG - Faculdade da Serra Gaúcha
FTEC - Faculdade de Tecnologia TecBrasil
IDEAU - Instituto de Desenvolvimento Educacional do Alto Uruguai - Getúlio Vargas
SENAC - Faculdade Senac - Rio Grande do Sul
SJT - Instituição Educacional São Judas Tadeu
UNIANHANGUERA - Anhanguera Educacional S.A.
UNIRITTER - Centro Universitário Ritter dos Reis
FEMA - Escola Técnica e Superior Machado de Assis - Santa Rosa
FADISMA - Faculdade de Direito de Santa Maria
FAACS - Faculdade Anglo-Americano de Caxias do Sul
UNIR - Universidade Federal de Rondônia
IFRO - Instituto Federal de Rondônia
FCR - Faculdade Católica de Rondônia
UNIFSL - Centro Universitário São Lucas de Porto Velho
UNIFSL - Centro Universitário São Lucas de Ji-paraná
AVEC - Associação Vilhenense de Educação e Cultura
FAMA - Faculdade da Amazônia
FAEV/UNESC - Faculdade de Educação e Cultura de Vilhena
FARO - Faculdade de Ciências Humanas, Exatas e Letras de Rondônia
UNIRON - Faculdade Interamericana de Porto Velho
CEULJI/ULBRA - Centro Universitário Luterano de Ji-Paraná
FIMCA - Faculdades Integradas Aparício Carvalho
FIAR - Faculdades Integradas de Ariquemes
FAAR - Faculdades Associadas de Ariquemes
ILES/ULBRA - Instituto Luterano de Ensino Superior de Porto Velho
FAEMA - Faculdade de Educação e Meio Ambiente
FACIMED - Faculdade de Ciências Biomédicas de Cacoal
UNESC - Faculdades Integradas de Cacoal
UNIJIPA - Faculdade Panamericana de Ji-Paraná
UERR - Universidade Estadual de Roraima
UFRR - Universidade Federal de Roraima
IFRR - Instituto Federal de Roraima
Estácio - Estácio Atual
FACETEN - Faculdade de Ciências, Educação e Teologia do Norte do Brasil
Cathedral - Faculdades Cathedral
FARES - Faculdade Roraimense de Ensino Superior
FURB - Fundação Universidade Regional de Blumenau
SOCIESC - Sociedade Educacional de Santa Catarina
UNESC - Universidade do Extremo Sul Catarinense
USJ - Universidade Municipal de São José
FMP - Faculdade Municipal de Palhoça
CEETEPS-Centro Estadual de Educação Tecnológica Paula Souza
UDESC - Universidade do Estado de Santa Catarina
UFFS - Universidade Federal da Fronteira Sul
IFSC - Instituto Federal de Santa Catarina
IFC - Instituto Federal Catarinense
UFSC - Universidade Federal de Santa Catarina
ACE - Associação Catarinense de Ensino
FACC - Faculdade Concórdia
FAACH - Faculdade Santa Rita de Chapecó
FAP - Faculdade Santa Rita Palmitos
SENAC - Faculdade Senac - Santa Catarina
UNOESC - Universidade do Oeste de Santa Catarina
UNIASSELVI - Centro Universitário Leonardo da Vinci
UNIBAVE - Universidade Barriga Verde
UNIFEBE - Centro Universitário de Brusque 
UNISUL - Universidade do Sul de Santa Catarina
UNC - Universidade do Contestado
UNIARP - Universidade Alto Vale do Rio do Peixe
UNERJ - Centro Universitário de Jaraguá do Sul
UNIVALI - Universidade do Vale do Itajaí
UNIVILLE - Universidade da Região de Joinville
UNOCHAPECÓ - Universidade Comunitária Regional de Chapecó
UNIPLAC - Universidade do Planalto Catarinense
UNISUL - Universidade do Sul de Santa Catarina
UNITAU - Universidade de Taubaté
USCS - Universidade Municipal de São Caetano do Sul
Uni-FACEF (Centro Universitário Municipal de Franca).
UNIFAE - Centro Universitário das Faculdades Associadas de Ensino
Uni-FACEF - Centro Universitário de Franca
CUFSA - Centro Universitário Fundação Santo André
FACCAMP - Faculdade de Campo Limpo Paulista
EEP/FUMEP - Escola de Engenharia de Piracicaba
ESEFIC - Escola Superior de Cruzeiro "Prefeito Hamilton Vieira Mendes"
ESEFJ - Escola Superior de Educação Física de Jundiaí
FITO - Fundação Instituto Tecnológico de Osasco
FATEB - Faculdade de Ciências e Tecnologia de Birigui
FDF - Faculdade de Direito de Franca
FDSBC - Faculdade de Direito de São Bernardo do Campo
FAIBI - Faculdade de Filosofia, Ciências e Letras de Ibitinga
FFCL - Faculdade de Filosofia Ciências e Letras de São José do Rio Pardo
FMABC - Faculdade de Medicina do ABC
FMJ - Faculdade de Medicina de Jundiaí
FMPFM - Faculdade Municipal Professor Franco Montoro de Mogi Guaçu
FAI - Faculdades Adamantinenses Integradas
FAFEM - Faculdades da Fundação de Ensino de Mococa
FUNEC - Faculdades Integradas de Santa Fé do Sul
IESF - Instituto de Ensino Superior da Fupesp
IMMES - Instituto Matonense Municipal de Ensino Superior
IMESB - Instituto Municipal de Ensino Superior de Bebedouro Victório Cardassi
IMES Catanduva - Instituto Municipal de Ensino Superior de Catanduva
IMESSM - Instituto Municipal de Ensino Superior de São Manuel
IMESA - Instituto Municipal de Ensino Superior de Assis
FEA - Fundação Educacional Araçatuba
USP - Universidade de São Paulo
UNICAMP - Universidade Estadual de Campinas
UNESP - Universidade Estadual Paulista
UNIVESP - Universidade Virtual do Estado de São Paulo
FAMEMA - Faculdade de Medicina de Marília
FAMERP - Faculdade de Medicina de São José do Rio Preto
FATEC - Faculdade de Tecnologia do Estado de São Paulo
APMBB - Academia de Polícia Militar do Barro Branco
UFSCar - Universidade Federal de São Carlos
UNIFESP - Universidade Federal de São Paulo
UFABC - Universidade Federal do ABC
INPE-Instituto Nacional de Pesquisas Espaciais
IFSP - Instituto Federal de Educação, Ciência e Tecnologia de São Paulo
ITA - Instituto Tecnológico de Aeronáutica
AFA - Academia da Força Aérea
PUC-SP - Pontifícia Universidade Católica de São Paulo
PUC-Campinas - Pontifícia Universidade Católica de Campinas
UNISANTOS - Universidade Católica de Santos
UNISA - Universidade de Santo Amaro
UNIVAP - Universidade do Vale do Paraíba
UNOESTE - Universidade do Oeste Paulista
USF - Universidade São Francisco
UNISANT'ANNA - Universidade Sant'Anna
UMESP - Universidade Metodista de São Paulo
UNAERP - Universidade de Ribeirão Preto
MACK - Universidade Presbiteriana Mackenzie
UNIMEP - Universidade Metodista de Piracicaba
UNICASTELO - Universidade Camilo Castelo Branco
UNISAL - Centro Universitário Salesiano de São Paulo
UNICID-Universidade Cidade de São Paulo
UNIARARAS-Centro Universitário da Fundação Hermínio Ometto
CBM - Centro Universitário Barão de Mauá
UNISALESIANO - Centro Universitário Católico Salesiano Auxilium
CUSC - Centro Universitário São Camilo
FEBASP - Centro Universitário Belas Artes de São Paulo
FEI - Centro Universitário FEI
UNIFEV-Centro Universitário de Votuporanga
FMU - Centro Universitário das Faculdades Metropolitanas Unidas
SENAC - Centro Universitário Senac - São Paulo
UNASP - Centro Universitário Adventista de São Paulo
UNIARA - Universidade de Araraquara
UNICEP - Centro Universitário Central Paulista
UNIFAI - Centro Universitário Assunção
UNIFEB - Centro Universitário da Fundação Educacional de Barretos
UNIFEOB - Centro Universitário Octávio Bastos
UNIFIEO - Centro Universitário FIEO
UNILAGO - União das Faculdades dos Grandes Lagos
UNIMONTE - Centro Universitário Monte Serrat
UNORP - Centro Universitário do Norte Paulista
UNIRP - Centro Universitário de Rio Preto
UNIVEM - Centro Universitário Eurípedes de Marília
ACCC-A.C.Camargo Cancer Center
FCN - Faculdade Canção Nova
BSP - Business School São Paulo
FGV - Fundação Getúlio Vargas
FATEC - Faculdade de Teologia e Ciências
FECAP - Fundação Escola de Comércio Álvares Penteado
ESPM - Escola Superior de Propaganda e Marketing
ESAGS - Escola Superior de Administração e Gestão
IMT - Instituto Mauá de Tecnologia
FCL - Faculdade Cásper Líbero
FAAP - Fundação Armando Álvares Penteado
Insper - Instituto de Ensino e Pesquisa
IMT - Instituto Mauá de Tecnologia
FESPSP - Fundação Escola de Sociologia e Política de São Paulo
FRB - Faculdades Integradas Rio Branco
DOMPEDRO - Faculdades Integradas Dom Pedro II
FIO - Faculdades Integradas de Ourinhos
FIRB - Faculdades Integradas Rio Branco
FTML - Faculdade de Teologia Metodista Livre
FTT - Faculdade de Tecnologia Termomecânica
FAPCOM - Faculdade Paulus de Comunicação e Tecnologia
UCESP - Faculdade União Cultural do Estado de São Paulo
UniSãopaulo - Instituto São Paulo de Formação e Especialização Profissional
FAZP - Faculdade Zumbi dos Palmares
FEF - Fundação Educacional de Fernandópolis
FCMSCSP - Faculdade de Ciências Médicas da Santa Casa de São Paulo
FD - Faculdade Dehoniana
FDC-Fundação Dom Cabral
UNINOVE - Campus Memorial - São Paulo/SP.
ICESP-Universidade Brasil
CEUNSP - Centro Universitário Nossa Senhora do Patrocínio
FCDA - Faculdade Drummond
ISES - Centro Universitário Sumaré
ITE - Centro Universitário de Bauru
UAM - Universidade Anhembi Morumbi
UBC - Universidade Braz Cubas
UMC - Universidade de Mogi das Cruzes
UNG - Universidade Guarulhos
UniABC - Universidade do Grande ABC
UNIBAN - Universidade Bandeirante de São Paulo
UNIBERO - Centro Universitário Anhanguera de São Paulo
UNICSUL - Universidade Cruzeiro do Sul
UNISEB - Centro Universitário Estácio UniSEB -São Paulo
UNIFRAN - Universidade de Franca
UNIMAR - Universidade de Marília
UNINOVE - Universidade Nove de Julho
UNIP - Universidade Paulista
UNIMES - Universidade Metropolitana de Santos
UNISANTA - Universidade Santa Cecília
UNISO - Universidade de Sorocaba
USJT - Universidade São Judas Tadeu
AESA - Anhanguera Educacional
FACAMP - Faculdades de Campinas
FACIC - Faculdade de Ciências Humanas de Cruzeiro
FACMIL - Faculdade de Administração de São José do Rio Preto
FADI - Faculdade de Direito de Sorocaba
FADISC - Faculdades Integradas de São Carlos
FALS - Faculdade do Litoral Sul Paulista
FAM - Faculdade de Americana
FIAP - Faculdade de Informática e Administração Paulista
FADITU - Faculdade de Direito de Itu
FIRB - Faculdades Integradas Rio Branco
FIT - Faculdade Impacta Tecnologia
FMS - Faculdade Mario Schenberg
FNC - Faculdade Nossa Cidade
FOC - Faculdades Oswaldo Cruz
JAPI - Faculdade Japi
SLMANDIC - Faculdade de Odontologia e Centro de Pesquisas Odontológicas São Leopoldo Mandic
TECMED - Faculdade de Tecnologia Tecmed
BANDTEC - Faculdade de Tecnologia Bandeirantes
FLAMINGO - Faculdade Flamingo
UFS - Universidade Federal de Sergipe
IFS - Instituto Federal de Sergipe
Unit - Universidade Tiradentes
FPD - Faculdade Pio Décimo
ESTÁCIO - Faculdade Estácio de Sergipe
FANESE - Faculdade de Administração e Negócios de Sergipe
FAMA - Faculdade Amadeus
FSLF - Faculdade São Luis de França
UNOPAR - Universidade Norte do Paraná
FASER - Faculdade Sergipana
FACAR - Faculdade de Aracaju
UNIRB - Faculdade Serigy
FAJAR - Faculdade Jardins
FA - Faculdade Atlântico
UNIPLAN - Universidade do Planalto de Brasília
UNIDOM - Universidade Dom Pedro II
UniCOC - Sistema COC de Educação
UNINASSAU - Faculdade Maurício de Nassau
UnirG - Centro Universitário UnirG
UNITINS - Fundação Universidade do Tocantins
IFTO - Instituto Federal do Tocantins
UFT - Universidade Federal do Tocantins
UNICATÓLICA - Centro Universitário Católica do Tocantins
FACDO - Faculdade Católica Dom Orione
FACIT - Faculdade de Ciências do Tocantins
FECIPAR - Faculdade de Educação Ciências e Letras de Paraíso
FAPAL - Faculdade de Palmas
FAG - Faculdade Guaraí
FIESC - Faculdade Integrada de Ensino Superior de Colinas
FASEC - Faculdade Serra do Carmo
IEPO - Instituto de Ensino e Pesquisa Objetivo
ITPAC - Instituto Tocantinense Presidente Antônio Carlos
CEULP/ULBRA - Centro Universitário Luterano de Palmas
ITPAC Porto - Instituto Tocantinense Presidente Antônio Carlos de Porto Nacional
UNEST - União Educacional de Ensino Superior do Médio Tocantins